#############
e..#.#...#..#
##.#.##.##.##
#....#....#..
###.##.##.###
#...........#
#####.#######
#..........##
##.##########
...#.#...#..#
##x#.##.##.##
